###########################################################							
##														 ##
##														 ##	
##														 ##	
##														 ##	
##														 ##	
##														 ##
##														 ##	
##														 ##	
##														 ##	
##														 ##	
##														 ##
##														 ##
##														 ##
##														 ##
##														 ##
##														 ##
##														 ##
##														 ##
##														 ##
##														 ##
##														 ##
##														 ##
##														 ##
##														 ##
##														 ##
##														 ##
##														 ##
##														 ##
###########################################################