#############################################################
##                                             ##          ##
##                                             ##          ##
##                                             ##          ##
##      ########################    ##         ##          ##
##      ##                          ##         ##          ##
##########                          ##                     ##
##                                  ##                     ##
##             ##########           ##########             ##
##                     ##                   ##             ##
##                     ##                   ##             ##
##                     ################################    ##
##                                           ##            ##
#################                            ##            ##
##             ##                            ##            ##
##             ##                            ##            ##
##             #################             ##            ##
##                                           ##            ##
##                                           ##            ##
##                                           ##            ##
##                                           ##            ##
##                                           ##            ##
##                                  ###################    ##
##             ##########                    ##            ##
##             ##                            ##            ##
#################                       ############       ##
##                                        %%%%%%%%%        ##
##                                        %% *   %%        &#
##                                        %%     %%        ##
##                                        %%     %%        ##
#############################################################
